########################
#......................#
#...#..................#
#...##........#..#..#..#
#....##.......####..#..#
#.....###.....#..#..#..#
#.......#..............#
#.......#..............#
#......................#
#..........P...........#
#......................#
#....#########.........#
#......................#
#......................#
#......#...............#
#......#...............#
#......#.......#.......#
#......#......###......#
#......#.......#.......#
#......#...............#
#......................#
#......#...............#
#......#...............#
########################