########################
#......................#
#......................#
#..##..##..##..##..##..#
#..##..##..##..##..##..#
#......................#
#......................#
#....##..##..##..##....#
#....##..##..##..##....#
#......................#
#......................#
#..##..##..##..##..##..#
#..##..##..##..##..##..#
#......................#
#......................#
#....##..##..##..##....#
#....##..##..##..##....#
#......................#
#......................#
#..##..##..##..##..##..#
#..##..##..##..##..##..#
#......................#
#...............P......#
########################
